64
64
23 23 23 23 23 23 23 23 23 23 23 23 23 23 23 23 23 23 23 23 23 23 23 23 23 23 23 23 23 23 23 23 23 23 23 23 23 23 23 23 20 2 2 2 2 2 2 20 23 23 23 23 23 23 23 23 23 23 23 23 23 23 23 23 
23 3 3 3 3 3 3 23 23 3 3 3 3 3 3 23 23 3 3 3 3 3 3 23 23 3 3 3 3 3 3 23 23 3 3 3 3 3 3 23 20 2 2 2 2 2 2 20 23 3 3 3 3 3 3 23 23 3 3 3 3 3 3 23
23 3 3 3 3 3 3 23 23 3 3 3 3 3 3 23 23 3 3 3 3 3 3 23 23 3 3 3 3 3 3 23 23 3 3 3 3 3 3 23 20 2 2 2 2 2 2 20 23 3 3 3 3 3 3 23 23 3 3 3 3 3 3 23
23 3 3 3 3 3 3 4 4 3 3 3 3 3 3 4 4 3 3 3 3 3 3 23 23 3 3 3 3 3 3 4 4 3 3 3 3 3 3 23 20 2 2 1 1 2 2 20 23 3 3 3 3 3 3 4 4 3 3 3 3 3 3 23
23 3 3 3 3 3 3 4 4 3 3 3 3 3 3 4 4 3 3 3 3 3 3 23 23 3 3 3 3 3 3 4 4 3 3 3 3 3 3 23 20 2 2 1 1 2 2 20 23 3 3 3 3 3 3 4 4 3 3 3 3 3 3 23
23 3 3 3 3 3 3 23 23 3 3 3 3 3 3 23 23 3 3 3 3 3 3 23 23 3 3 3 3 3 3 23 23 3 3 3 3 3 3 23 20 2 2 1 1 2 2 20 23 3 3 3 3 3 3 23 23 3 3 3 3 3 3 23
23 3 3 3 3 3 3 23 23 3 3 3 3 3 3 23 23 3 3 3 3 3 3 23 23 3 3 3 3 3 3 23 23 3 3 3 3 3 3 23 20 2 2 1 1 2 2 20 23 3 3 3 3 3 3 23 23 3 3 3 3 3 3 23
23 23 23 23 23 23 23 23 23 23 23 4 4 23 23 23 23 23 23 23 23 23 23 23 23 23 23 4 4 23 23 23 23 23 23 23 23 23 23 23 20 2 2 1 1 2 2 20 23 23 23 4 4 23 23 23 23 23 23 4 4 23 23 23
23 23 23 23 23 23 23 23 23 23 23 4 4 23 23 23 23 23 23 23 23 23 23 23 23 23 23 4 4 23 23 23 20 20 20 20 20 20 20 20 20 2 2 1 1 2 2 20 23 23 23 4 4 23 23 23 23 23 23 4 4 23 23 23
23 3 3 3 3 3 3 23 23 3 3 3 3 3 3 23 23 3 3 3 3 3 3 23 23 3 3 3 3 3 3 23 20 2 2 2 2 2 2 2 2 2 2 1 1 2 2 20 23 3 3 3 3 3 3 23 23 3 3 3 3 3 3 23
23 3 3 3 3 3 3 23 23 3 3 3 3 3 3 23 23 3 3 3 3 3 3 23 23 3 3 3 3 3 3 23 20 2 2 2 2 2 2 2 2 2 2 1 1 2 2 20 23 3 3 3 3 3 3 23 23 3 3 3 3 3 3 23
23 3 3 3 3 3 3 4 4 3 3 3 3 3 3 4 4 3 3 3 3 3 3 4 4 3 3 3 3 3 3 23 20 2 2 1 1 1 1 1 1 1 1 1 1 2 2 20 23 3 3 3 3 3 3 23 23 3 3 3 3 3 3 23
23 3 3 3 3 3 3 4 4 3 3 3 3 3 3 4 4 3 3 3 3 3 3 4 4 3 3 3 3 3 3 23 20 2 2 1 1 1 1 1 1 1 1 1 1 2 2 20 23 3 3 3 3 3 3 23 23 3 3 3 3 3 3 23
23 3 3 3 3 3 3 23 23 3 3 3 3 3 3 23 23 3 3 3 3 3 3 23 23 3 3 3 3 3 3 23 20 2 2 1 1 2 2 2 2 2 2 2 2 2 2 20 23 3 3 3 3 3 3 23 23 3 3 3 3 3 3 23
23 3 3 3 3 3 3 23 23 3 3 3 3 3 3 23 23 3 3 3 3 3 3 23 23 3 3 3 3 3 3 23 20 2 2 1 1 2 2 2 2 2 2 2 2 2 2 20 23 3 3 3 3 3 3 23 23 3 3 3 3 3 3 23
23 23 23 4 4 23 23 23 23 23 23 4 4 23 23 23 23 23 23 23 23 23 23 23 23 23 23 23 23 23 23 23 20 2 2 1 1 2 2 20 20 20 20 20 20 20 20 20 23 23 23 4 4 23 23 23 23 23 23 23 23 23 23 23
23 23 23 4 4 23 23 23 20 20 20 24 25 20 20 20 20 20 20 20 20 20 20 20 20 20 20 20 20 20 20 20 20 2 2 1 1 2 2 20 23 23 23 23 23 23 23 23 23 23 23 4 4 23 23 23 23 23 23 23 23 23 23 23
23 3 3 3 3 3 3 23 20 2 2 1 1 2 2 2 2 2 2 2 2 2 2 2 2 2 2 2 2 2 2 2 2 2 2 1 1 2 2 20 23 3 3 3 3 3 3 23 23 3 3 3 3 3 3 23 23 3 3 3 3 3 3 23
23 3 3 3 3 3 3 23 20 2 2 1 1 2 2 2 2 2 2 2 2 2 2 2 2 2 2 2 2 2 2 2 2 2 2 1 1 2 2 20 23 3 3 3 3 3 3 23 23 3 3 3 3 3 3 23 23 3 3 3 3 3 3 23
23 3 3 3 3 3 3 23 20 2 2 1 1 1 1 1 1 1 1 1 1 1 1 1 1 1 1 1 1 1 1 1 1 1 1 1 1 2 2 20 23 3 3 3 3 3 3 23 23 3 3 3 3 3 3 4 4 3 3 3 3 3 3 23
23 3 3 3 3 3 3 23 20 2 2 1 1 1 1 1 1 1 1 1 1 1 1 1 1 1 1 1 1 1 1 1 1 1 1 1 1 2 2 20 23 3 3 3 3 3 3 23 23 3 3 3 3 3 3 4 4 3 3 3 3 3 3 23
23 3 3 3 3 3 3 23 20 2 2 2 2 2 2 2 2 2 2 2 2 2 2 2 2 2 2 2 2 2 2 2 2 2 2 1 1 2 2 20 23 3 3 3 3 3 3 23 23 3 3 3 3 3 3 23 23 3 3 3 3 3 3 23
23 3 3 3 3 3 3 23 20 2 2 2 2 2 2 2 2 2 2 2 2 2 2 2 2 2 2 2 2 2 2 2 2 2 2 1 1 2 2 20 23 3 3 3 3 3 3 23 23 3 3 3 3 3 3 23 23 3 3 3 3 3 3 23
23 23 23 23 23 23 23 23 20 20 20 20 20 20 20 20 20 20 20 20 20 20 20 20 20 20 20 20 20 20 20 20 20 2 2 1 1 2 2 20 23 23 23 4 4 23 23 23 23 23 23 4 4 23 23 23 23 23 23 4 4 23 23 23
23 23 23 23 23 23 23 23 23 23 23 23 23 23 23 23 23 23 23 23 23 23 23 23 20 20 20 20 20 20 20 20 20 2 2 1 1 2 2 20 23 23 23 4 4 23 23 23 23 23 23 4 4 23 23 23 23 23 23 4 4 23 23 23
23 3 3 3 3 3 3 23 23 3 3 3 3 3 3 23 23 3 3 3 3 3 3 23 20 2 2 2 2 2 2 20 20 2 2 1 1 2 2 20 23 3 3 3 3 3 3 23 23 3 3 3 3 3 3 23 23 3 3 3 3 3 3 23
23 3 3 3 3 3 3 23 23 3 3 3 3 3 3 23 23 3 3 3 3 3 3 23 20 2 1 1 1 1 2 20 20 2 2 1 1 2 2 20 23 3 3 3 3 3 3 23 23 3 3 3 3 3 3 23 23 3 3 3 3 3 3 23
23 3 3 3 3 3 3 4 4 3 3 3 3 3 3 23 23 3 3 3 3 3 3 23 20 2 1 1 1 1 2 20 20 2 2 1 1 2 2 20 23 3 3 3 3 3 3 4 4 3 3 3 3 3 3 23 23 3 3 3 3 3 3 23
23 3 3 3 3 3 3 4 4 3 3 3 3 3 3 23 23 3 3 3 3 3 3 23 20 2 1 1 1 1 2 20 20 2 2 1 1 2 2 20 23 3 3 3 3 3 3 4 4 3 3 3 3 3 3 23 23 3 3 3 3 3 3 23
23 3 3 3 3 3 3 23 23 3 3 3 3 3 3 23 23 3 3 3 3 3 3 23 20 2 1 1 1 1 2 20 20 2 2 1 1 2 2 20 23 3 3 3 3 3 3 23 23 3 3 3 3 3 3 23 23 3 3 3 3 3 3 23
23 3 3 3 3 3 3 23 23 3 3 3 3 3 3 23 23 3 3 3 3 3 3 23 20 2 2 1 1 2 2 20 20 2 2 1 1 2 2 20 23 3 3 3 3 3 3 23 23 3 3 3 3 3 3 23 23 3 3 3 3 3 3 23
23 23 23 4 4 23 23 23 23 23 23 23 23 23 23 23 23 23 23 4 4 23 23 23 20 2 2 1 1 2 2 20 20 2 2 1 1 2 2 20 23 23 23 23 23 23 23 23 23 23 23 23 23 23 23 23 23 23 23 4 4 23 23 23
23 23 23 4 4 23 23 23 23 23 23 23 23 23 23 23 23 23 23 4 4 23 23 23 20 2 2 1 1 2 2 20 20 2 2 1 1 2 2 20 20 20 20 20 20 20 20 20 20 20 20 20 20 20 20 20 20 20 20 21 22 20 20 20
23 3 3 3 3 3 3 23 23 3 3 3 3 3 3 23 23 3 3 3 3 3 3 23 20 2 2 1 1 2 2 2 2 2 2 1 1 2 2 2 2 2 2 2 2 2 2 2 2 2 2 2 2 2 2 2 2 2 2 1 1 2 2 2
23 3 3 3 3 3 3 23 23 3 3 3 3 3 3 23 23 3 3 3 3 3 3 23 20 2 2 1 1 2 2 2 2 2 2 1 1 2 2 2 2 2 2 2 2 2 2 2 2 2 2 2 2 2 2 2 2 2 2 1 1 2 2 2
23 3 3 3 3 3 3 4 4 3 3 3 3 3 3 4 4 3 3 3 3 3 3 23 20 2 2 1 1 1 1 1 1 1 1 1 1 1 1 1 1 1 1 1 1 1 1 1 1 1 1 1 1 1 1 1 1 1 1 1 1 2 2 2
23 3 3 3 3 3 3 4 4 3 3 3 3 3 3 4 4 3 3 3 3 3 3 23 20 2 2 1 1 1 1 1 1 1 1 1 1 1 1 1 1 1 1 1 1 1 1 1 1 1 1 1 1 1 1 1 1 1 1 1 1 2 2 2
23 3 3 3 3 3 3 23 23 3 3 3 3 3 3 23 23 3 3 3 3 3 3 23 20 2 2 1 1 2 2 2 2 2 2 2 2 2 2 2 2 2 2 2 2 2 2 2 2 2 2 2 2 2 2 2 2 2 2 2 2 2 2 2
23 3 3 3 3 3 3 23 23 3 3 3 3 3 3 23 23 3 3 3 3 3 3 23 20 2 2 1 1 2 2 2 2 2 2 2 2 2 2 2 2 2 2 2 2 2 2 2 2 2 2 2 2 2 2 2 2 2 2 2 2 2 2 2
23 23 23 4 4 23 23 23 23 23 23 23 23 23 23 23 23 23 23 23 23 23 23 23 20 2 2 1 1 2 2 20 20 20 20 20 20 20 20 20 20 20 20 20 20 20 20 20 20 20 20 20 20 20 20 20 20 20 20 20 20 20 20 20
23 23 23 4 4 23 23 23 23 23 23 23 23 23 23 23 20 20 20 20 20 20 20 20 20 2 2 1 1 2 2 20 23 23 23 23 23 23 23 23 23 23 23 23 23 23 23 23 23 23 23 23 23 23 23 23 23 23 23 23 23 23 23 23
23 3 3 3 3 3 3 23 23 3 3 3 3 3 3 23 20 2 2 2 2 2 2 20 20 2 2 1 1 2 2 20 23 3 3 3 3 3 3 23 23 3 3 3 3 3 3 23 23 3 3 3 3 3 3 23 23 3 3 3 3 3 3 23
23 3 3 3 3 3 3 23 23 3 3 3 3 3 3 23 20 2 2 2 2 2 2 20 20 2 2 1 1 2 2 20 23 3 3 3 3 3 3 23 23 3 3 3 3 3 3 23 23 3 3 3 3 3 3 23 23 3 3 3 3 3 3 23
23 3 3 3 3 3 3 23 23 3 3 3 3 3 3 23 20 2 2 1 1 2 2 20 20 2 2 1 1 2 2 20 23 3 3 3 3 3 3 4 4 3 3 3 3 3 3 4 4 3 3 3 3 3 3 4 4 3 3 3 3 3 3 23
23 3 3 3 3 3 3 23 23 3 3 3 3 3 3 23 20 2 2 1 1 2 2 20 20 2 2 1 1 2 2 20 23 3 3 3 3 3 3 4 4 3 3 3 3 3 3 4 4 3 3 3 3 3 3 4 4 3 3 3 3 3 3 23
23 3 3 3 3 3 3 23 23 3 3 3 3 3 3 23 20 2 2 1 1 2 2 20 20 2 2 1 1 2 2 20 23 3 3 3 3 3 3 23 23 3 3 3 3 3 3 23 23 3 3 3 3 3 3 23 23 3 3 3 3 3 3 23
23 3 3 3 3 3 3 23 23 3 3 3 3 3 3 23 20 2 2 1 1 2 2 20 20 2 2 1 1 2 2 20 23 3 3 3 3 3 3 23 23 3 3 3 3 3 3 23 23 3 3 3 3 3 3 23 23 3 3 3 3 3 3 23
23 23 23 4 4 23 23 23 23 23 23 4 4 23 23 23 20 2 2 1 1 2 2 20 20 2 2 1 1 2 2 20 23 23 23 4 4 23 23 23 23 23 23 4 4 23 23 23 23 23 23 4 4 23 23 23 23 23 23 23 23 23 23 23
23 23 23 4 4 23 23 23 23 23 23 4 4 23 23 23 20 2 2 1 1 2 2 20 20 2 2 1 1 2 2 20 23 23 23 4 4 23 23 23 23 23 23 4 4 23 23 23 23 23 23 4 4 23 23 23 23 23 23 23 23 23 23 23
23 3 3 3 3 3 3 23 23 3 3 3 3 3 3 23 20 2 2 1 1 2 2 20 20 2 2 1 1 2 2 20 23 3 3 3 3 3 3 23 23 3 3 3 3 3 3 23 23 3 3 3 3 3 3 23 23 3 3 3 3 3 3 23
23 3 3 3 3 3 3 23 23 3 3 3 3 3 3 23 20 2 2 1 1 2 2 20 20 2 2 1 1 2 2 20 23 3 3 3 3 3 3 23 23 3 3 3 3 3 3 23 23 3 3 3 3 3 3 23 23 3 3 3 3 3 3 23
23 3 3 3 3 3 3 4 4 3 3 3 3 3 3 23 20 2 2 1 1 2 2 20 20 2 2 1 1 2 2 20 23 3 3 3 3 3 3 23 23 3 3 3 3 3 3 23 23 3 3 3 3 3 3 4 4 3 3 3 3 3 3 23
23 3 3 3 3 3 3 4 4 3 3 3 3 3 3 23 20 2 2 1 1 2 2 20 20 2 2 1 1 2 2 20 23 3 3 3 3 3 3 23 23 3 3 3 3 3 3 23 23 3 3 3 3 3 3 4 4 3 3 3 3 3 3 23
23 3 3 3 3 3 3 23 23 3 3 3 3 3 3 23 20 2 2 1 1 2 2 20 20 2 2 1 1 2 2 20 23 3 3 3 3 3 3 23 23 3 3 3 3 3 3 23 23 3 3 3 3 3 3 23 23 3 3 3 3 3 3 23
23 3 3 3 3 3 3 23 23 3 3 3 3 3 3 23 20 2 2 1 1 2 2 20 20 2 2 1 1 2 2 20 23 3 3 3 3 3 3 23 23 3 3 3 3 3 3 23 23 3 3 3 3 3 3 23 23 3 3 3 3 3 3 23
23 23 23 4 4 23 23 23 23 23 23 23 23 23 23 23 20 2 2 1 1 2 2 20 20 2 2 1 1 2 2 20 23 23 23 23 23 23 23 23 23 23 23 4 4 23 23 23 23 23 23 4 4 23 23 23 23 23 23 23 23 23 23 23
20 20 20 26 27 20 20 20 20 20 20 20 20 20 20 20 20 2 2 1 1 2 2 20 20 2 2 1 1 2 2 20 20 20 20 20 20 20 20 20 20 20 20 28 29 20 20 20 23 23 23 4 4 23 23 23 23 23 23 23 23 23 23 23
2 2 2 1 1 2 2 2 2 2 2 2 2 2 2 2 2 2 2 1 1 2 2 2 2 2 2 1 1 2 2 2 2 2 2 2 2 2 2 2 2 2 2 1 1 2 2 20 23 3 3 3 3 3 3 23 23 3 3 3 3 3 3 23
2 2 2 1 1 2 2 2 2 2 2 2 2 2 2 2 2 2 2 1 1 2 2 2 2 2 2 1 1 2 2 2 2 2 2 2 2 2 2 2 2 2 2 1 1 2 2 20 23 3 3 3 3 3 3 23 23 3 3 3 3 3 3 23
2 2 2 1 1 1 1 1 1 1 1 1 1 1 1 1 1 1 1 1 1 1 1 1 1 1 1 1 1 1 1 1 1 1 1 1 1 1 1 1 1 1 1 1 1 2 2 20 23 3 3 3 3 3 3 4 4 3 3 3 3 3 3 23
2 2 2 1 1 1 1 1 1 1 1 1 1 1 1 1 1 1 1 1 1 1 1 1 1 1 1 1 1 1 1 1 1 1 1 1 1 1 1 1 1 1 1 1 1 2 2 20 23 3 3 3 3 3 3 4 4 3 3 3 3 3 3 23
2 2 2 2 2 2 2 2 2 2 2 2 2 2 2 2 2 2 2 2 2 2 2 2 2 2 2 2 2 2 2 2 2 2 2 2 2 2 2 2 2 2 2 2 2 2 2 20 23 3 3 3 3 3 3 23 23 3 3 3 3 3 3 23
2 2 2 2 2 2 2 2 2 2 2 2 2 2 2 2 2 2 2 2 2 2 2 2 2 2 2 2 2 2 2 2 2 2 2 2 2 2 2 2 2 2 2 2 2 2 2 20 23 3 3 3 3 3 3 23 23 3 3 3 3 3 3 23
2 2 2 2 2 2 2 2 2 2 2 2 2 2 2 2 2 2 2 2 2 2 2 2 2 2 2 2 2 2 2 2 2 2 2 2 2 2 2 2 2 2 2 2 2 2 2 20 23 23 23 23 23 23 23 23 23 23 23 23 23 23 23 23